###############
#.............#
#.............#
#.............#
#.............*
#.............#
#.............#
#.............#
#.............#
###############