###############
#.............#
#.............#
#.............#
*.............*
#.............#
#.............#
#.............#
#.............#
#######*#######