###############
#.............#
#.............#
#.............#
#.............#
#.............#
#.............#
#.............#
#.............#
#######*#######