###############
#.............#
#.............#
#.............#
*.............#
#.............#
#.............#
#.............#
#.............#
###############